DDDDDDDDDDFFFFFDDDDFFFFFFDDDDDFTFFFFFFFFFFFFRRRFFFFFFFFTFFFFDDDDDFFFFFFFFFFFDDDDDDDDDDDDDDMMMMMDDDDRRRFFFFFFFFDDDDMMMMMMMMMMMDDDDDDDDDDDDDDDDDDDDDDDDD
DDDDDDDDDDFFFTFDDDDFFFFFFDDDDDFFFFFFFFFFFTFFRRRFFFFFFFFFFFFFDDDDDFFFFFFFFFFFDDDDDDDDDDDDDDMMMMMDDDDRRRFFFFFFFFDDDDMMMMMMMMMMMDDDDDDDDDDDDDDDDDDDDDDDDD
DDDDDDDDDDFFFFFDDDDFFFFFFDDDDDFFFFFFFFFFFFFFRRRFFFFFFFFFFFFFDDDDDFFFFFFFFTFFDDDDDDDDDDDDDDMMMMMDDDDRRRFFFFFFFFDDDDMMMMMMMMMMMDDDDDDDDDDDDDDDDDDDDDDDDD
DDDDDDDDDDFFFFFDDDDFFFFFFDDDDDFFTFFFFFFFFFFFRRRFFFFFFFFFFFFFDDDDDFFFFFFFFFFFDDDDDDDDDDDDDDMMMMMDDDDRRRFFFFFFFFDDDDMMMMMMMMMMMDDDDDDDDDDDDDDDDDDDDDDDDD
DDDDDDDDDDFFFFFDDDDFFFFFFDDDDDFFFFTFFTFFFFFFRRRFFFFFFFFFFFFFDDDDDFFFFFFFFFFFDDDDDDDDDDDDDDMMMMMDDBDRRRFFFFFFFFDDDDMMMMMMMMMMMDDDDDDDDDDDDDDDDDDDDDDDDD
DDDDDMMMMMDDDDDDDDDFFFFFFFFFFFGGGGGGGGFFFFFFRRRFFFFFFFFFFFFFFFFFFDDDDDFFFFFTMMMMDDDDDMMMMMMMMMMDDBDRRRFFFFFFFFDDDDMMMMMMMMMMMMMMMMDDDDDDDDDDMMMMMDDDDD
DDDDDMMMMMDDDDDDDDDFFFFFFFTFFFGGGGGGGGFFFFFFRRRFFFFFFFFFFFFFFFFFFDDDDDFFFFFFMMMMDDDDDMMMMMMMMMMDDDDRRRFFFFFFFFDDDDMMMMMMMMMMMMMMMMDDDDDDDDDDMMMMMDDDDD
DDDDDMMMMMDDDDDDDDDTFFFFFFFFFFGGGGGGTGFFFFFFRRRFFFTFFFFFFFFFFFFFFDDDDDFFFFFFMMMMDDDDDMMMMMMMMMMDDDDRRRFFFFFFFFDDDDMMMMMMMMMMMMMMMMDDDDDDDDDDMMMMMDDDDD
DDDDDMMMMMDDDDDDDDDFFFFFFFFFFFGGGGGGGGFFFFFFRRRFFFFFFFFFFFFFFFFFFDDDDDFFFFFFMMMMDDDDDMMMMMMMMMMDDDBRRRFFFFFFFFDDDDMMMMMMMMMMMMMMMMDDDDDDDDDDMMMMMDDDDD
DDDDDMMMMMDDDDDDDDDFFFFFFFFFFFGGGGGGGGFFFFFFRRRFFFFFFFFFFFFFFFFFFDDDDDFFFFFFMMMMDDDDDMMMMMMMMMMDDDBRRRFFFFFFFFDDDDMMMMMMMMMMMMMMMMDDDDDDDDDDMMMMMDDDDD
DDDDDDDDDDDDDDDFFFFTFFFFFFFFFFFFFFFDDDMMDDDDRRRMMMDDDDDDDDDDFFFFFFFFFFFFFFFDMMMMMMMMMMMMMMMMMMMDDDDRRRDDDFFFFFFFFFDDDDDDDDDDDDDDDDMMMMMMMMMMDDDDDMMMMM
DDDDDDDDDDDDDDDFFFFGFFFFFFFFFFFFFFFDDDMMDBDDRRRMMMDDDDDDDDDDFFFFFFFFFFFFFFFDMMMMMMMMMMMMMMMMMMMDDDDRRRDBDFFFFFFFFFDDDDDDDDDDDDDDDDMMMMMMMMMMDDDDDMMMMM
DDDDDDDDDDDDDDDFFFFGFFFFFFFFFFFFFFFDDDMMDDDDRRRMMMDDDDDDDDDDFFFFFFFTFFFFFFFDMMMMMMMMMMMMMMMMMMMDDDDRRRDDDFFFFFFFFFDDDDDDDDDDDDDDDDMMMMMMMMMMDDDDDMMMMM
DDDDDDDDDDDDDDDFTFFGFFFFFFFFFFFFFFFDDDMMDDDDRRRMMMDDDDDDDDDDFFFFFFFFFFFFFFFDMMMMMMMMMMMMMMMMMMMDDDDRRRDDDFFFFFFFFFDDDDDDDDDDDDDDDDMMMMMMMMMMDDDDDMMMMM
DDDDDDDDDDDDDDDFFFFGFFFFFFFFFFFFFFFDDDMMDDDDRRRMMMDDDDDDDDDDFFFFFFFFFFFTFFFDMMMMMMMMMMMMMMMMMMMDDDDRRRDDDFFFFFTFFFDDDDDDDDDDDDDDDDMMMMMMMMMMDDDDDMMMMM
DDDDDDDDDDFFFFFFFFFGGGGGGGGGGGDDDDDDDDDDMMMMRRRDDDDDDDDDDFFFFFFFFFFFFFDDDDDDMMMMMMMMMMMMMMMMMMMDDDDRRRDDDFFFFFFFFFDDDDDDMMMMMDDDDDMMMMMMMMMMMMMMMDDDDD
DDDDDDDDDDFFFFFFFFFGGGGGGGGGGGDDDDDDDDDDMMMMRRRDDDDDDDDDDFFFFFFFFFFFFFDDDDDDMMMMMMMMMMMMMMMMMMMDDDBRRRDDDFFFFFFFFFDDDDDDMMMMMDDDDDMMMMMMMMMMMMMMMDDDDD
DDDDDDDDDDFFFFFFFFFGGGGGGGGGGGDDDDDDDDDDMMMMRRRDDDDDDDDDDFFFFFFFFTFFFFDDDDDDMMMMMMMMMMMMMMMMMMMDDDDRRRBDDFFFFFFFFFDDDDDDMMMMMDDDDDMMMMMMMMMMMMMMMDDDDD
DDDDDDDDDDTFFFFFFFTGGGGGGGGGGGDDDDDDDDDDMMMMRRRDDDDDDDDDDFFFFFFFFFFFFFDDDDDDMMMMMMMMMMMMMMMMMMMDDDDRRRDDDFFFFFFFFFDDDDDDMMMMMDDDDDMMMMMMMMMMMMMMMDDDDD
MMMMMMMMMMDDDDDDDDDGGTGGGFFFFFDDDDDDDDDDDDDDRRRFFFFFFFFFFGGGSSSSSSSSSSFFFFFFDDDDFFFFFDDDDDFFFFFMMMMRRRMMMDDDDDDDDDDDDDDDDDDDDDDDDDMMMMMMMMMMMMMMMDDDDD
DDDDDDDDDDMMMMMMMMMDFFFTFFFFFFDDDDDDDDFFFFFFRRRFFFFFFFFFFGGGSSSSSGGGGTGGGGGGTFFFFTFFFFFFFFDDDDDMMMMRRRDDDDDDDDDDDDDDDDDDDDDDDDDDDDDDDMMMMMMMMMMMMDDDDD
DDDDDDDDDDMMMMMMMMMDFFTFFFFFFFDDDDDDDDFFFFFFRRRFFFFFFFFFFGGGSSSSSGGGGGGGGGGGFFFFFFFFFFFFFFDDDDDMMMMRRRDDDDDDDDDDDDDDDDDDDDDDDDDDDDDDDMMMMMMMMMMMMDDDDD
DDDDDDDDDDMMMMMMMMMDFFFFFFFFFFDDDDDDDDFFFFFFRRRFFFFTFFFFFGGGSSSSSGGGGGGGGGTGFFTFFFFFFFFFFFDDDDDMMMMRRRDDDDDDDDDDDDDDDDDDDDDDDDDDDDDDDMMMMMMMMMMMMDDDDD
DDDDDDDDDDMMMMMMMMMDFFFFFFFFFFDDDDDDDDFFFFFFRRRFFFFFFFFFFGGGSSSSSGGGGGGGGGTGFFFFFFFFFFFFFFDDDDDMMMMRRRDBDDDDDDDDDDDDDDDDDDDDDDDDDDDDDMMMMMMMMMMMMDDDDD
DDDDDDDDDDMMMMMMMMMDFFFFFFFFFFDDDDDDDDFFFFFFRRRFFFFFFFFFFGGGSSSSSGGGTGGGGGGTFFFFFFFFFFFFFFDDDDDMMMMRRRDDDDDDDDDDDDDDDDDDDDDDDDDDDDDDDMMMMMMMMMMMMDDDDD
DDDDDDDDDDMMMMMMMMMFFFFFFFFFFFDDDDDDDDFFFFFFRRRFFFFFFFFFFFFFGGGGGSSSSSGGGGGTDDDDFFFFFFFFFFFFFFFMMMMRRRDDDDDDDDDDDDDDDDDDDDDDDFFFFFDDDMMMMMMMDDDDDDDDDD
DDDDDDDDDDMMMMMMMMMFFFFFFFFFFFDDDDDDDDFFFFFFRRRFFTFFFFFFFFFFGGGGGSSSSSGGGGGGDDDDFFFFFFFFFFFFFFFMMMMRRRDDDDDDDDDDDDDDDDDDDDDDDFFFFFDDDMMMMMMMDDDDDDDDDD
DDDDDDDDDDMMMMMMMMMFFFFFFFFFFFDDDDDDDDFFFFFFRRRFFFFFFFFFFFFFGGGGGSSSSSGGGGGGDDDDFFFFFFFFFFFFFFFMMMMRRRDDDDDDDDDDDDDDDDDDDDDDDFFFFFDDDMMMMMMMDDDDDDDDDD
DDDDDDDDDDMMMMMMMMMFFFFFFFFFFFDDDDDDDDFFFFFFRRRFFFFTFFFFFFFFGGGGGSSSSSGGGGGGDDDDFFFFFFFFFFFTFFFMMMMRRRDDDDDDDDDDDDDDDDDDDDDDDFFFFFDDDMMMMMMMDDDDDDDDDD
DDDDDDDDDDMMMMMMMMMFFFFFFFFFFFDDDDDDDDFFFFFFRRRFFFFFFFFFFFFFGGTGGSSSSSGGGGGGDDDDFFTFFFFFFFFFFFFMMMMRRRDDDDDDDDDDDDDDDDDDDDDDDFFFFFDDDMMMMMMMDDDDDDDDDD
DDDDDDDDDDMMMMMMMMMFFFFFFFFFFFFFFFFFFFFFFFFFRRRFFFGGGGGFFTGTGGGGGGGGGGSSSSSSFFFFDDDDDDDDDDFFFFFDDDDRRRMMMMMMMMDDDDDFFFFFDDDDDMMMMMDDDDDMMMMMMMMMMMMMMM
DDDDDDDDDDMMMMMMMMMFFFFFFFTFFFFFFFFFFFFFFFFFRRRFFFGGGGGFFGGGGGGGGGGGGGSSSSSSFFFFDDBDDDDDDDFFFFFDDDDRRRMMMMMMMMBDDDDFFFFFDDDDDMMMMMDDDDBMMMMMMMMMMMMMMM
DDDDBDDDDDMMMMMMMMMFFFFFFFFFFFFFFTFFFFFFFFFFRRRFFFGGGGGFFGGGGGGGGGGGGGSSSSSSFFFFDDDDDDDDDDFFFFFDDDDRRRMMMMMMMMDDDDDFFFFFDDDDDMMMMMDDDDDMMMMMMMMMMMMMMM
DDDDDDDDDDMMMMMMMMMFFFFFFFFFFFFFFFFFFFFFFFFFRRRFFFGGGGGFFGGGBGGGGGGGGGSBSSSSFFFFDDDDDDDDDDFFFFFDDDDRRRMMMMMMMMDDDDDFFFFFDDDDDMMMMMDDDDDMMMMMMMMMMMMMMM
RRRRRRRRRRRRRRRRRRRRRRRRRRRRRRRRRRRRRRRRRRRRRRRRRRRRRRRRRRRRRRRRRRRRRRRRRRRRRRRRRRRRRRRRRRRRRRRRRRRRRRRRRRRRRRRRRRRRRRRRRRRRRRRRRRRRRRRRRRRRRRRRRRRRRR
RRRRRRRRRRRRRRRRRRRRRRRRRRRRRRRRRRRRRRRRRRRRRRRRRRRRRRRRRRRRRRRRRRRRRRRRRRRRRRRRRRRRRRRRRRRRRRRRRRRRRRRRRRRRRRRRRRRRRRRRRRRRRRRRRRRRRRRRRRRRRRRRRRRRRR
RRRRRRRRRRRRRRRRRRRRRRRRRRRRRRRRRRRRRRRRRRRRRRRRRRRRRRRRRRRRRRRRRRRRRRRRRRRRRRRRRRRRRRRRRRRRRRRRRRRRRRRRRRRRRRRRRRRRRRRRRRRRRRRRRRRRRRRRRRRRRRRRRRRRRR
DDDDDDDDDDMMMMMMMMMFFFFFFFFFFFDDDDDFFFFFFFFFRRRFFFFFFFFFFGBTGGGGGGGGGGSSBSSWFFFFDDDDDDBBDDFFFFFDBDDRRRMMMMMMMMBBDDFFFFFFMMMMMDDDDDDDDMMMMMMMMMMMMMMMMM
WWWWWWWWWWGGGGGGGGGGSSBSSSSSSSFFFFFGGGMMDBDDRRRMMMDDDDDDDDDDDDDDDDDDDDFFFFFFGGGGDDDDDDDDDDFFFFFDDBDRRRDDDDDDDDFFFFFTFFFFFFFFFFFFFFFFFDDDDDDDMMMMMMMMMM
WWWWWWWWWWGGGGGGGGGGSSSSSSSSSSFFFFFGGGMMDDDDRRRMMMDDDDDDDDDDDDDDDDDDDDFFFFFFGGGGDDDDDDDDDDFFFFFDDDDRRRDDDDDDDDFFFFFFFFFFFFFFFFFFFFFFFDDDDDDDMMMMMMMMMM
SSSSSSSSSSWWWWWWWWWWSSSSSSSSSSGGGGGGGGMMDDDDRRRMMMDDDDDDDFFTMMMMMDDDDDMMMMMDFFFFFFFFFFFFFFFFFFFDDDDRRRFFFFFFFFDDDDFDDDDDFFFFFFFFFFFFFBDDDDDDMMMMMMMMMM
SSSSSSSSSSWWWWWWWWWWSSSSSSSSSSGGGGGGGGMMDDDDRRRMMMDDDDDDDFFFMMMMMDDDDDMMMMMDFFFFFFFFFFFFFFFFFFFDDDDRRRFFFFFFFFDDDDFDDDDDFFFFFFFFFFFFFDDDDDDDMMMMMMMMMM
SSSSSSSSSSWWWWWWWWWWSSSSSSSSSSGGGGGGGGMMDDDDRRRMMMDDDDDDDFFFMMMMMDDDDDMMMMMDFFFFFFFFFFFFFFFFFFFDDDDRRRFFFFFFFFDDDDFDDDDDFFFFFFFFFFFFFDDDDDDDMMMMMMMMMM
SSSSSSSSSSWWWWWWWWWWSSSSSSSSSSGGGGGGGGMMDDDDRRRMMMDDDDDDDFFFMMMMMDDDDDMMMMMDFFFFFFFFFFFFFFFFFFFDDDDRRRFFFFFFFFDDDDFDDDDDFFFFFFFFFFFFFDDDDDDDMMMMMMMMMM
SSSSSSSSSSWWWWWWWWWWSSSSSSSSSSGGGGGGGGMMDDDDRRRMMMDDDDDDDFFFMMMMMDDDDDMMMMMDFFFFFFFFFFFFFFFFFFFDDBDRRRFFFFFFFFDDDDFDDDDDFFFFFFFFFFTFFDDDDDDDMMMMMMMMMM
GGGGGSSSSSSSSSSWWWWWSSSSSSSSSSGGGGGGGGMMDDDDRRRDDDFFFFFFFFFFDDDDDDDDDDMMMMMMDDDDFFFFFFFFFFFFFFFDDDDRRRFFFFFFTFDDDDFFFFFFFFFFFFFFFFFFFMMMMMMMMMMMMDDDDD
GGGGGSSSSSSSSSSWWWWWSSSSSSSSSSGGGGGGGGMMDDDDRRRDBDFFFFFFFFFFDDDDDDDDDDMMMMMMDDDDFFFFFFFFFFFFFFFDDDDRRRFFFFFFFFDDDDFFFFFFFFFFFFFFFFFFFMMMMMMMMMMMMDDDDD
GGGGGSSSSSSSSSSWWWWWSSSSSSSSSSGGGGGGGGMMDDDDRRRDDDFFFFFFFFFFDDDDDDDDDDMMMMMMDDDDFFFFFFFFFFFFTFFDDDDRRRFFFFFFFFDDDDFFFFFFFFFFFFFFFFFFFMMMMMMMMMMMMDDDDD
GGGGGSSSSSSSSSSWWWWWSSSSSSSSSSGGGGGGGGMMDDDDRRRDDDFFFFFFFFFFDDDDDDDDDDMMMMMMDDDDFFFFFFFFFFTFFFFDDDDRRRFFFFFFFFDDDDFFFFFFFFFFFFFFFFFFFMMMMMMMMMMMMDDDDD
GGGGGSSSSSSSSSSWWWWWSSSSSSSSSSGGGTGGGGMMDDDBRRRDDDFFFFFFFFFFDDDDDDDDDDMMMMMMDDDDFTFFFFFFFFFFFFFDDDDRRRFFFFFFFFDDDDFFFFFFFFFFFFFFFFFFFMMMMMMMMMMMMDDDDD
SSSSSWWWWWGGGGGGGGGGWWWWWSSSSSWWWWWWWWFFDDDDRRRMMMDDDDDMMDDDDDDDDDDDDDDDDDDDFFFFFFFFFFFFFFDDDDDDDDDRRRDDDFFFFFFFFFFFFFFFFFFFFFFFFFTFFMMMMMMMDDDDDDDDDD
SSSSSWWWWWGGGGGGGGGGWWWWWSSSSSWWWWWWWWFFDDDDRRRMMMDDDDDMMDDDDDDDDDDDDDDDDDDDFFFFFFFFFFFFFFDDDDDDDDDRRRDDDFFFFFFFFFFFFFFFFFFFFFFFFFFFFMMMMMMMDDDDDDDDDD
SSSSSWWWWWGGGGGGGGTGWWWWWSSSSSWWWWWWWWFFDDDBRRRMMMDDDDDMMDDDDDDDDDDDDDDDDDDDFFFFFFFFFTFFFFDDDDDDDDDRRRDDDFFFFFFFFTFFFFFFFFFFFFFFFFFFFMMMMMMMDDDDDDDDDD
SSSSSWWWWWGGGGGGGGGGWWWWWSSSSSWWWWWWWWFFDDDDRRRMMMDDDDDMMDDDDDDDDDDDDDDDDDDDFFFFFFFFFFFFFFDDDDDDDDDRRRDDDFFFFFFFFFFFFFFFFFFFFFFFFFFFFMMMMMMMDDDDDDDDDD
SSSSSWWWWWGGGGGGGGGGWWWWWSSSSSWWWWWWWWFFDDDDRRRMMMDDDDDMMDDDDDDDDDDDDDDDDDDDFFFFFFFFFFFFFFDDDDDDDDDRRRDDDFFFFFFFFFFFFFFFFFFFFFFFFFFFFMMMMMMMDDDDDDDDDD
WWWWWWWWWWGGGGGTFFFTWWWWWWWWWWSSSSSWWWDDMMMMRRRMMMDDDDDDDFFFDDDDDDDDDDDDDDDDDDDDFFFFFFFFFFDDDDDMMMMRRRFFFFFFFFDDDDDFFFFFFFFFFFFFFFDDDMMMMMMMDDDDDFFFFF
WWWWWWWWWWGGGGGFFFFFWWWWWWWWWWSSSSSWWWDDMMMMRRRMMMDDDDDDDFFFDDDDDDDDDDDDDDDDDDDDFFFFFFFFFFDDDDDMMMMRRRFFFFFFFFDDDDDFFFTFFFFFFFFFFFDDDMMMMMMMDDDDDFFFFF
SSSSSSSSSSGGTGGFFFFFGGGGGGGGGGTTGGTGGGDDMMMMRRRMMMMMMMMMMDDDDDDDDDDDDDDDDDDMMMMMDDDDDDDDDDMMMMMMMMMRRRDDDDDDDDMMMMDDDDDDFFFFFDDDDDMMMDDDDDDDFFFFFFTFFF
SSSSSSSSSSGGGGGFFFFFGGGGGGGGGGGGGGGGGGDDMMMMRRRMMMMMMMMMMDDDDDDDDDDDDDDDDDDMMMMMDDDDDDDDDDMMMMMMMMMRRRDBDDDDDDMMMMDDDDDDFFFFFDDDDDMMMDDDDDDDFFFFFFFFFF
SSSSSSSSSSGGGGGFFFFFGGGGGGGTGGGGGGGGGGDDMMMMRRRMMMMMMMMMMDDDDDDDDDDDDDDDDDDMMMMMDDDDDDDDDDMMMMMMMMMRRRDDDDDDDDMMMMDDDDDDFFFFFDDDDDMMMDDDDDDDFFFFFFFFFF
SSSSSSSSSSGGGGGFFFFDFFFFFFFFFFFFFTFFFFMMMMMMRRRMMMMMMMMMMDDDDDDDDDDDDDFFFFFDMMMMMMMMMMMMMMMMMMMMMMMRRRBDDDDDDDDDDDFFFFFFDDDDDDDDDDFFFFFFFFFFDDDDDDDDDD
SSSSSSSSSSGGGTGFFFFDFFFFFFFFFFFFFFFFFFMMMMMMRRRMMMMMMMMMMDDDDDDDDDDDDDFFFFFDMMMMMMMMMMMMMMMMMMMMMMMRRRDDDDDDDDDDDDFFFFFFDDDDDDDDDDFFFFFFFFFFDDDDDDDDDD
SSSSSSSSSSGGGGGFFFFDFFFFFFTFFFFFFFFFFFMMMMMMRRRMMMMMMMMMMDDDDDDDDDDDDDFFFFFDMMMMMMMMMMMMMMMMMMMMMMMRRRDDDDDDDDDDDDFFFFFFDDDDDDDDDDFFFFFFFFFFDDDDDDDDDD
SSSSSSSSSSGGGGGFFFFDFFFFFFFFFFFFFFFFFFMMMMMMRRRMMMMMMMMMMDDDDDDDDDDDDDFFFFFDMMMMMMMMMMMMMMMMMMMMMMMRRRDDDDDDDDDDDDFFFFFFDDDDDDDDDDFFFFFFFFFFDDDDDDDDDD
SSSSSSSSSSGGGGGFFFFDFFFFFFFTFFFFFFFFFFMMMMMMRRRMMMMMMMMMMDDDDDDDDDDDDDFFFFFDMMMMMMMMMMMMMMMMMMMMMMMRRRDDDDDDDDDDDDFFFFFFDDDDDDDDDDFFFFFFFFFFDDDDDDDDDD
SSSSSSSSSSFFFFFGGGGFFFFFFFFFFFFFFFFFFFMMMMMMRRRMMMMMMMMMMDDDDDDDDDDDDDFFFFFFDDDDMMMMMMMMMMMMMMMMMMMRRRDDDMMMMMDDDDFFFFFFDDDDDDDDDDFFFFFFFFFFDDDDDDDDDD
SSSSSSSSSSFFFTFGGGGFFFFFFFTFFFFFFFFFFFMMMMMMRRRMMMMMMMMMMDDDDDDDDDDDDDFFFFFFDDDDMMMMMMMMMMMMMMMMMMMRRRDDDMMMMMDDDDFFFFFFDDDDDDDDDDFFFFFFFFFFDDDDDDDDDD
SSSSSSSSSSTFFFFGGGGFFFFFFFFFFFFFFFFFFFMMMMMMRRRMMMMMMMMMMDDDDDDDDDDDDDFFFFFFDDDDMMMMMMMMMMMMMMMMMMMRRRDDDMMMMMDDDDFFFFFFDDDDDDDDDDFTFFFTFFFFDDDDDDDDDD
SSSSSSSSSSFFFFFGGGGFFFFFFFFFFFFFFFFFFFMMMMMMRRRMMMMMMMMMMDDDDDDDDDDDDDFFFFFFDDDDMMMMMMMMMMMMMMMMMMMRRRDDDMMMMMDDDDFFFFFFDDDDDDDDDDFFFFFFFFFFDDDDDDDDDD
SSSSSSSSSSFFFFTGGGGFFFFFFFFFFFFFFFFFFFMMMMMMRRRMMMMMMMMMMDDDDDDDDDDDDDFFFFFFDDDDMMMMMMMMMMMMMMMMMMMRRRDDDMMMMMDDDDFFFFFFDDDDDDDDDDFFFFFFFFFFDDDDDDDDDD
SSSSSWWWWWFFFFFGGGGFFFFFFGGGGGGGGGGGGGDDMMMMRRRMMMMMMMMMMDBDFFFFFFFFFFDDDDDDMMMMMMMMMMMMMMMMMMMMMMMRRRBDBDDDDDDDDDFFTFFFFFFFFFFFFFFFFFFFFFFTFFFFFFFFFF
SSSSSWWWWWFFFFFGGGGFFFFFFGGGGGGGGGGGGGDDMMMMRRRMMMMMMMMMMDDDFFFFFFFFFTDDDDDDMMMMMMMMMMMMMMMMMMMMMMMRRRDBDDDDDDDDDDFFFFFFFFTFFFFFFFFFFFFFFFFFFFFFFFFFFF
SSSSSWWWWWFFFFFGGGGFFFFFFGGGGGGGGGBGGGDDMMMMRRRMMMMMMMMMMDDDFFFFFFFFFFDBDDDDMMMMMMMMMMMMMMMMMMMMMMMRRRDDBDDDBDDDDDFFFFFFFFFFTFFFFFFFFFFFFFFFFFFFFFFFFF
SSSSSWWWWWFFTFFGGGGFFFFFFGGGGGGGGGBGGGDDMMMMRRRMMMMMMMMMMDDBFFTFFFFFFFDDDDDBMMMMMMMMMMMMMMMMMMMMMMMRRRDBBDDDDDDDDDFFFFFFFFFFFFFFFFFFFFFFFFFFFFFFFFFFFF
RRRRRRRRRRRRRRRRRRRRRRRRRRRRRRRRRRRRRRRRRRRRRRRRRRRRRRRRRRRRRRRRRRRRRRRRRRRRRRRRRRRRRRRRRRRRRRRRRRRRRRRRRRRRRRRRRRRRRRRRRRRRRRRRRRRRRRRRRRRRRRRRRRRRRR
RRRRRRRRRRRRRRRRRRRRRRRRRRRRRRRRRRRRRRRRRRRRRRRRRRRRRRRRRRRRRRRRRRRRRRRRRRRRRRRRRRRRRRRRRRRRRRRRRRRRRRRRRRRRRRRRRRRRRRRRRRRRRRRRRRRRRRRRRRRRRRRRRRRRRR
RRRRRRRRRRRRRRRRRRRRRRRRRRRRRRRRRRRRRRRRRRRRRRRRRRRRRRRRRRRRRRRRRRRRRRRRRRRRRRRRRRRRRRRRRRRRRRRRRRRRRRRRRRRRRRRRRRRRRRRRRRRRRRRRRRRRRRRRRRRRRRRRRRRRRR
GGGGGGGGTGFFFFFFFFFSWWWWWWWWWWWWWWWWWWGGFFFTRRRGGGFFFFFFFGGGSSSBSSSSSSSSSSSSFFFFBDDDDBDDDDDBDDDDDDDRRRFFFFFFFFFFFFDDDDDDDDDDDDDBDDDDDMMMMMMMDDDBDMMMMM
GGGGTGGGBGFFFFFFFFFSWWWWWWWWWWWWWWWWWWGGFFFFRRRGGGFFFFFFFTGGSSSBSSSSSSSSSSSBFFFFDDDDDDDDDDDDDBDDDDDRRRFFFFFFFFFFFFDDDDDDDDDDDDDDDDDDDMMMMMMMDDDDDMMMMM
GGGGGGGGGGFFFFFFFFFSWWWWWWWWWWWWWWWWWWGGFFFFRRRGTGFFFFFFFGGGSSSSSBSSSSSSBSSSFFFFDDDDDDDDDDDDDDDDBDDRRRFFFFFFFFFFFFDDDDDDDDDDDDDDDDDDDMMMMMMMDDDDDMMMMM
SSSSSGGGGGGGGGGGGGGWGGGGGGGGGGWWWWWSSSBGGGBGRRRGBGTFFFFFFGGGGGGGGGGGGGGGGGGGDDDDFFFFFFFFFFFFFFFFFFFRRRFFFFFFFFFFFFMDDDDDMMMMMDDDDDMMMMMMMMMMMMMMMMMMMM
SSSSSGGGGGGGGGGGGGTWGGGGGGGGGGWWWWWSSSGGGGGGRRRGGGFFFFFFFGGGGGGGGGGGGGGGGGGGDDDDFFFFFFFFFFFFFFFFFFFRRRFFFFFFFFFFFFMDDDDDMMMMMDDDDDMMMMMMMMMMMMMMMMMMMM
SSSSSGGGGGGGGGGGGGGWGGGTGGGGGGWWWWWSSSGGGGGGRRRGGGFFFFFFFGGGGGGGGGGGTGGGGGGGDDDDFFFFFFFFFFFFFFFFFFFRRRFFFFFFFFFFTFMDDDDDMMMMMDDDDDMMMMMMMMMMMMMMMMMMMM
SSSSSGGGGGGGTGGGGGGWGGGGGGGGGGWWWWWSSSGGGGGGRRRGGGFFFFFFFGGGGGTGGGGGGGGGGGGGDDDDFFFFFFFFFFFFFFFFFFFRRRFFFFFFFFFFFFMDDDDDMMMMMDDDDDMMMMMMMMMMMMMMMMMMMM
SSSSSGGGGGGGGGGGGGGWGGGGGGGGGGWWWWWSSSGGGGGGRRRGGGFFFFFFFGGGGGGGGGGGGGGGGGGGDDDDFFFFFFFFFFFFFFFFFFFRRRFFFFFFFTFFFFMDDDDDMMMMMDDDDDMMMMMMMMMMMMMMMMMMMM
GGGGGTGGGGFFFFFFFFFWSSSSSSSSSSSSSSSWWWGGBBSSRRRGGGFFFFFFFFTFGGGGGGGGGGGGGGGFDDDDFFFFFFFFFFFFFFFFFFFRRRBDDFFFFFFFFFDMMMMMMMMMMMMMMMMMMMMMMMMMMMMMMMMMMM
GGGGGGGGGTFFFFFFFFFWSSSSSSSSSSSSSSSWWWGGSSSSRRRGGGFFFFFFFFFFGGGGGGGGGGGGGGGFDDDDFFFFFFFFFFFFFFFFFFFRRRBDDFFFFFFFFFDMMMMMMMMMMMMMMMMMMMMMMMMMMMMMMMMMMM
GGGGGGGGGGFFFFFFFFFWSSSSSSSSSSSSSSSWWWGGSSSSRRRGGGFFFFFFFFFFGGGGGGGGGGGGGGGFDDDDFFFFFFFFFFFFFFFFFFFRRRDDDFFTFFFFFFDMMMMMMMMMMMMMMMMMMMMMMMMMMMMMMMMMMM
TGGGGGGGGGFFFFFFFFFWSSSSSSSSSSSSSSSWWWGGSSSSRRRGGGFFFFTFFFFFGGGGGGGGGGGGGGGFDDDDFFFFFFFFFFFFFFFFFFFRRRDDDFFFFFFFTFDMMMMMMMMMMMMMMMMMMMMMMMMMMMMMMMMMMM
TGGGGGGGGGFFFFFFFFFWSSSSSSSSSSSSSSSWWWGGSSSSRRRGGGFFFFFFFFFFGGGGGGGGGGGGGGGFDDDDFFFFFFFFFFFFFFFFFFFRRRDDDFFFFFFFFFDMMMMMMMMMMMMMMMMMMMMMMMMMMMMMMMMMMM
FFFFFFFFFFFFFFFFFFFGWWWWWWWWWWWWWWWSSSGGGGBGRRRFFFGGGGGSSSSSWWWWWWWWWWSSSSSGFFFFDDDDDDDDDDFFFFFFFFFRRRDDDDDDDDDDDDMMMMMMMMMMMMMMMMMMMMMMMMMMDDDDDMMMMM
FFFFFFFFFFFFFFFFFFFGWWWWWWWWWWWWWWWSSSGGGGGGRRRFFFGGGGGSSSSSWWWWWWWWWWSSSSSGFFFFDDDDDDDDDDFFFFFFFFFRRRDDDDDDDDDDDDMMMMMMMMMMMMMMMMMMMMMMMMMMDDDDDMMMMM
FFFFFFFFFFFFFFFFFFFGWWWWWWWWWWWWWWWSSSGGGGGGRRRFFFGGGGGSSSSSWWWWWWWWWWSSSSSGFFFTDDDDDDDDDDFFFFFFFFFRRRDDDDDDDDDDDDMMMMMMMMMMMMMMMMMMMMMMMMMMDDDDDMMMMM
FFFFFFFFFFFFFFFFFFFGWWWWWWWWWWWWWWWSSSGGGGGGRRRFFFGGGGGSSSSSWWWWWWWWWWSSSSSGFFFFDDDDDDDDDDFFFFFFFFFRRRDDDDDDDDDDDDMMMMMMMMMMMMMMMMMMMMMMMMMMDDDDDMMMMM
FFFFFFFFFFFFFFFFFFFGWWWWWWWWWWWWWWWSSSGGGGGGRRRFFFGGGGGSSSSSWWWWWWWWWWSSSSSGFFFFDDDDDDDDDDFFFFFFFFFRRRDDBDDDDDDDDDMMMMMMMMMMMMMMMMMMMMMMMMMMDDDDDMMMMM
SSSSSSSSSSFFFFTFFFFFGGGGGSSSSSGGGGGGGGGGGGGGRRRGGGGGGGGGGGGGGGGGGSSSSSGGGGGGFFFFDDDDDDDDDDFFFFFFFFFRRRDDDFFFFFFFFFMMMMMMMMMMMDDDDDMMMMMMMMMMDDDDDMMMMM
SSSSSSSSSSFFFFFFFFFFGGGGGSSSSSGGGGGGGGGGGGGGRRRGGGGGGGGGGGGGGGGGGSSSSSGGGGGGFFFFDDDDDDDDDDFFFFFFFFFRRRDDDFFFFFFFFFMMMMMMMMMMMDDDDDMMMMMMMMMMDDDDDMMMMM
SSSSSSSSSSFFFFFFFFFFGGGGGSSSSSGGGGGGGGGGGGGGRRRGGGGGGGGGGGGGGGGGGSSSSSGGGGGGFFFFDDDDDDDDDDFFFFFFFFFRRRDDBTFFFFFFFFMMMMMMMMMMMDDDDDMMMMMMMMMMDDDDDMMMMM
SSSSSSSSSSFFFFFFFFFFGGGGGSSSSSGGGGGGGGGGGGGGRRRGGGGGGGGGGGGGGTGTGSSSSSGGGGGGFFFFDDDDDDDDDDTFFFFFFFFRRRDDDFTFFFFFFFMMMMMMMMMMMDDDDDMMMMMMMMMMDDDDDMMMMM
SSSSSSSSSSFFFFFFFFFFGGGGGSSSSSGGGGGGGGTGGGGBRRRGGGTGGGGGGGGGGGGGGSSSSSGGGGGGFFFFDDDDDDDDDDFFFFFFFFFRRRDDDFFFFFFFFFMMMMMMMMMMMDDDDDMMMMMMMMMMDDDDDMMMMM
GGGGGGGGGGGGGGGGGGGGGGGGGGGGGGFFFFFGGGGGGGGGRRRFFFFFFFFGGGGGGGGGGFFFFFGGGGGGFFFFFFFFFFFFFFFFFFFFFFFRRRFFFFFFFFFFFFMMMMMMDDDDDDDDDDDDDDDDDDDDMMMMMMMMMM
GGGGGGGGGGGGGGGGGGGGGGGGGGGGGGFFFFFGGGGGGGGGRRRFFFFFFFFGGGGGGGGGGFFFFTGGGGGGFFFFFFFFFFFFFFFFFFFFFFFRRRFFFFFFFFFFFFMMMMMMDDDDDDDDDDDDDDDDDDDDMMMMMMMMMM
GTGGGGGGGGGGGGGGGGGGGGGGGGGGGGFFTFFGGGGGGGGGRRRFFFFFFFFTGGTGGGGGGFFFFFGGGGGGFFFFFFFFFFFFFFFFFFFFFFFRRRFFFFFFFFFFFFMMMMMMDDDDDDDDDDDDDDDDDDDDMMMMMMMMMM
GGGGGGGGGGGGGGGGGGGGGGGGGGGGGGFFFFFGGGGGGGGGRRRFFFFFFFFGGGGGGGGGGFFFFFGGGGGGFFFFFFFFFFFFFFFFFFFFFFFRRRFFFFFFFFFFFFMMMMMMDDDDDDDDDDDDDDDDDDDDMMMMMMMMMM
GGGGGTGGGGGGGGGGGGGGGGGGGGGGGGFFFFFGGGGGGGGGRRRFFFFFFFFGGGGGGGGGGFFFFFGGGGTGFFFFFFFFFFFFFFFFFFFFFFFRRRFFFFFFFFFFFFMMMMMMDDDDDDDDDDDDDDDDDDDDMMMMMMMMMM
FFFFFGGGGGFFFFFFFFFFGGGGGGGGGGGGGGGGGTGGFFFFRRRFFFGGGGGFFFFFFFFFFFFFFFGGGGGGFFFFFFFFFFFFFFFFFFFFFFTRRRFFFFFFFFTFFFMMMMMMDDDDDMMMMMDDDMMMMMMMDDDDDMMMMM
FFFFFGGGGGFFFFFFFFFFGGGGGGGGGGGGGGGGGGGGFFFFRRRFFFGGGGGFFFFFFFFFFFFFFFGGGGGGFFFFFFFFFFFFFFFFFFFFTFFRRRFFFFFFFFFFFFMMMMMMDDDDDMMMMMDDDMMMMMMMDDDDDMMMMM
FFFFFGGGGGFFFFFFFFFFGGGGGGTGGGGGGGGGGGGGFFFFRRRFFFGGGGGFFFFFFFFFFFFFFFGGGGGGFFFFFFFFFFFFFFFFFFFFFFFRRRFFFFFFFFFFFFMMMMMMDDDDDMMMMMDDDMMMMMMMDDDDDMMMMM
FFFFFGGGGGFFFFFFFFFFGGGGGGGGGGGGGGGGGGGGFFFFRRRFFFGGGGGFFFFFFFFFFFFFFTGGGGGGFFFFFFFFFFTFFFFFFFFFFFFRRRFFFFFFFFFFFFMMMMMMDDDDDMMMMMDDDMMMMMMMDDDDDMMMMM
FFFFFGGGGGFFFFFFFFFFGGGGGGGGGGGGGGGGGGGGFFFFRRRFFFGGGGGFFFFFFFFFFFFFFFGGGGGGFFFFFFFFFTFFFFFFFFFFFFFRRRFFTFFFFTFFFFMMMMMMDDDDDMMMMMDDDMMMMMMMDDDDDMMMMM
GGGGGFFFFFSSSSSSSSSSSSSSSSSSSSGGGGGFFFFFGGGGRRRSSSFFFFFGGGBGSSSSSSSSSSBSSSSSFFFFDDDDDFFFFFFFFFFGGGBRRRFFFFFFFFGGGGDDDDDDDDDDDDDDDDDDDDDDDDDDDDDDDDDDDD
GGGGGFFFFFSSSSSSSSSBSSSSSSSSSSGGGBGFFFFFGGGGRRRSSBFFFFFGGGGGSBSSSSSSSSSSSSSSFTFFDDDDDFFFFFFFFFFGGBGRRRFFFFFFFFTGGGDDBDDDDDDDDDDDDDDDDDDDDDDDDDDDDDDDDD
GGGGGFFFFFSSSSSSSSSSSSSSSSSSSSGGGGGFFFFFGGGGRRRSSSFFFFFGGGTGSSBSSSBSSSSSSSSSFFFFDDDBDFFFFTFFFFFGGGGRRRFFFFTFFFGGGGDDDDDDDBDDDDDDDDDDDDDDDDDDDDDDDDDDDD
GGGGGFFFFFSSSSSSSSSSSSSSSSSSSSGGGGGFFFFFGGGTRRRSSSFFFFFGGGGBSSSSSSSSSSSSSSSSFFFFDDDDDFFFFFFFFFFGGGGRRRFFFFFFFFGTGGDDDDDDBDDDDDDDDDDDDDDDDDDDDDDDDDDDDD
RRRRRRRRRRRRRRRRRRRRRRRRRRRRRRRRRRRRRRRRRRRRRRRRRRRRRRRRRRRRRRRRRRRRRRRRRRRRRRRRRRRRRRRRRRRRRRRRRRRRRRRRRRRRRRRRRRRRRRRRRRRRRRRRRRRRRRRRRRRRRRRRRRRRRR
RRRRRRRRRRRRRRRRRRRRRRRRRRRRRRRRRRRRRRRRRRRRRRRRRRRRRRRRRRRRRRRRRRRRRRRRRRRRRRRRRRRRRRRRRRRRRRRRRRRRRRRRRRRRRRRRRRRRRRRRRRRRRRRRRRRRRRRRRRRRRRRRRRRRRR
RRRRRRRRRRRRRRRRRRRRRRRRRRRRRRRRRRRRRRRRRRRRRRRRRRRRRRRRRRRRRRRRRRRRRRRRRRRRRRRRRRRRRRRRRRRRRRRRRRRRRRRRRRRRRRRRRRRRRRRRRRRRRRRRRRRRRRRRRRRRRRRRRRRRRR
DDBDDMMMMMFFFFFFFFFTFFFFFFFFFFDDDDDDDDDDFFFFRRRDDDMMMMMMMDDDDDDDDTFFFFFFFFFFSSSSFFFFFFFFFFWWWWWFFFFRRRGGGGGGTGGGGGSWWWWWWWWWWSSSSSSSSSBWWWWWWWWWWBSSSS
DDDDDMMMMMFFFTFFFFFFFFFFFTFFFFDDDDDDDDDDFFFFRRRDDDMMMMMMMBDDDDDDDFFFFTFFFFFFSSSSFFFFFFFFFFWWWWWFFFFRRRGGGGGBGGGBGGSWWWWWWWWWWSSSSSSSSSBWWWWWWWWWWSSSSS
DDDDDMMMMMFTFFFFFFFFFFFFFFFFFFDDDBDBDDDDFFFFRRRBDDMMMMMMMDDDDDDDDFFFFFFFFFFFSBSSFFFFFFFFFFWWWWWFFFFRRRGGGGGGGGGGGGSWWWWWWWWWWSSSSSSSSSSWWWWWWWWWWSSSSS
FFFFFFFFFFBDDDDDDDDDDDDDDDDDDDFFFFFFFFDDDDDDRRRDDDMMMMMDDTFFDDDDDDDDDDDDDDDDFFFFSSSSSWWWWWSSSSSGGGGRRRGGGFFFFFFFFFSSSSSSGGGGGGGGGGGGGGGGGGGGWWWWWSSSSS
FFFFFFFFFFDDDDDDDDDDDDDDDDDDDDFFFFFFFFDDDDDBRRRDDDMMMMMDDFFFDDDDDDDDDDDDDDDDFFFFSSSSSWWWWWSSSSSGGGGRRRGGGFFTFFFFFFSSSSSSGGGGGGGGGGGGGGTGGGGGWWWWWSSSSS
FFFFFFFFFFDDDDDDDDDDDDDDDDDDDDFFFFFFFFDDDDDDRRRDDDMMMMMDDFFFDDDDDDDDDDDDDDDDFFFFSSSSSWWWWWSSSSSGGGGRRRBGBFFFFFFFFFSSSSSSGGGGGGGGGGGTGGGGGGGGWWWWWSSSSS
FFFFFFFFFFDDDDDDDDDDDDDDDDDDDDFFFFFFFFDDDDDBRRRDDDMMMMMDDFFFDDDDDDDDDDDDDDDDFFFFSSSSSWWWWWSSSSSGGGGRRRBGGFFFFFFFFFSSSSSSGGGGGTGGGGGGGGGGGGGGWWWWWSSSSS
FFFFFFFFFFDDDDDDDDDDDDDDDDDDDDFFFFTFFFDDDDDBRRRBDDMMMMMDDFFFDDDDDDDDDDDDDDDDFFFFSSSSSWWWWWSSSSSGGGGRRRGGGFFFFFFFFFSSSSSSGGGGGGGTGGGGGGGGGGGGWWWWWSSSSS
FFFFFFFFFFDDDDDDDDDDDDDDDDDDDDDDDDDDDDDDDDDDRRRDDDDDDDDDDDDDDDDDDDDDDDDDDDDDFFFFWWWWWWWWWWSSSSSGGGGRRRGGGGGGGGGGGGSSSSSSSSSSSGGGGGGGTGGGGGGGSSSSSSSSSS
FFFFFFFFFTDDDDDDDDDDDDDDDDDDDDDDDDDDDDDDDDDDRRRDDDDDDDDDDDDDDDDDDDDDDDDDDDDDFFFFWWWWWWWWWWSSSSSGGGGRRRGGGGGGGGGGGGSSSSSSSSSSSGGGGGGGGGGGGGGGSSSSSSSSSS
TFFFFFFFFFDDDDDDDDDDDDDDDDDDDDDDDDDDDDDDDDDDRRRDDDDDDDDDDDDDDDDDDDDDDDDDDDDDFFFFWWWWWWWWWWSSSSSGGGGRRRGGGGGGGGGGGGSSSSSSSSSSSGGGGGGTGGGGGGGGSSSSSSSSSS
FFFFFFFFFFDDDDDDDDDDDDDDDDDDDDDDDDDDDDDDDDDDRRRDDDDDDDDDDDDDDDDDDDDDDDDDDDDDFFFFWWWWWWWWWWSSSSSGGGGRRRGGGGGGGGGGGGSSSSSSSSSSSGGGGGGGTGGGGGGGSSSSSSSSSS
FFFTFTFFFFDDDDDDDDDDDDDDDDDDDDDDDDDDDDDDDDDDRRRDDDDDDDDDDDDDDDDDDDDDDDDDDDDDFFFFWWWWWWWWWWSSSSSGGGGRRRGGBGGGGGGGGGSSSSSSSSSSSGGGGGGGGGGTGGGGSSSSSSSSSS
DDDDDFFFFFFFFFFFFFFFDDDDDDDDDDFFFFFFFFDDMMMMRRRMMMFFFFTFFFFFDDDDDDDDDDDDDDDDGGGGGGGGGFFFFFGGGGGFFFFRRRFFFFFFFFFFFFGGGGGGGGGGGFFTFFSSSGGSSSSSGGGGGTGGGG
DDDDDFFFFFFFFFFFFFTFDDDDDDDDDDFFFFFFFFDDMMMMRRRMMMFFFFFFFFFFDDDDDDDDDDDDDDDDGGGGGGGTGFFFFFGGGGGFFFFRRRFFFFFFFFFFFFGGGGGGGGGGGFFFFFSSSGGSSSSSGGGGGGGGGG
DDDDDFFFFFTFFFFFFFFFDDDDDDDDDDFFFFFFFFDDMMMMRRRMMMFFFFFFFFFFDDDDDDDDDDDDDDDDGGGGGGGGGFFFFFGGGGGFFFFRRRFFFFFFFFFFFFGGGGGGGGGGGFFFFFSSSGGSSSSSTGGGGGGGGG
MMMMMDDDDDDDDDDDDDDFFFFFFFFFFFGGGGGFFFFFDDDDRRRFFFGGGGGGGFFFDDDDDDDDDDDDDDDDFFFFFFFFFTFFFFFFFFFDDDDRRRFFFDDDDDFFFFFFFFFFFFFFFFFFFFGGGFFGGGGGFFFFFFFFFF
MMMMMDDDDDDDDDDDDDDFFFFFFFFFFFGGGGGFFFFFDBDDRRRFFTGGGGGGGFFFDDDDDDDDDDDDDDDDFFFFFFFFFFFFFFFFFFFDDDDRRRFFFDDDDDFFFFTFFFFFFFFFFFTFFFGGTFFGGGTGFFTFFFFFFF
DDDDDDDDDDDDDDDDDDDFFFFFFFFFFFGGGGGGGGGGFTFFRRRFFFFFFFFFFFFFDDDDDDDDDDDDDDDDFFFFFFFFFFFFFFFFFFFFFFFRRRFFFFFFFFDDDDFFFFFFFFFFFFFFTFGGGFFFFFFFFFFFFFFFFF
DDDDDDDDDDDDDDDDDDDFFFFFFFFFFFGGGGTGGGGGFFFFRRRFFFFFFFFFFFFFDDDDDDDDDDDDDDDDFFFTFFFFFFFFFFFFFFFFFFFRRRFFFFFFFFDDDDFFFFFFFFFFFFFFFFGGGFFFFFFFFFFFFFFFFF
DDDDDDDDDDDDDDDDDDDFFFFFTFFFFFGGGGGGGGGGFFFFRRRFFFFFFFFFFFFFDDDDDDDDDDDDDDDDFFFFFFFFFFFFFFFFFFFFFFFRRRFFFFFFFFDDDDFFFFFFFTFFFFFFFFGGGFFFFFFFFFFFFFFFFF
DDDDDDDDDDDDDDDDDDDFFFFFFFFFFFGGGGGGGGGGFFFFRRRFFFFFFFFFFFFFDDDDDDDDDDDDDDDDFFFFFFFFFFFFFFFFFTFFFFFRRRFFFFFFFFDDDDFFFFFFFFFFFFFFFFGGGFFFFFFFFFFFFFFFFF
DDDDDDDDDDDDDDDDDDDFFFFFFFFFFFGGTGGGGGGGFFFFRRRFFFTFFFFFFFFFDDDDDDDDDDDDDDDDFFFFFFFFFFFFFFFFFFFFFFFRRRFFFFFFFFDDDDFFFFFFFFFFFFFFFFGGGFFFFFFFFFFFFFFFFF
MMMMMMMMMMDDDDDDDDDFFFFFFFFFFFFFFFFFFFFFFFFFRRRFFFFFFFFGGFFFFFFFFFFFFFFFFFFFGGGGGGGGGGTGGGGGGTGFFFFRRRFFFFFFFFFFFFGFFFFFFFFFFFFFFFFFFFFFFFFFGGGGGFFFFF
MMMMMMMMMMDDDDDDDDDFFFFFFFFFFFFFFFFFFFFFFFFFRRRFFFFFFFFGGFFFFFFFFFFFFFFFFFFFGTGGGGGGGGGGGGGGGGGFFFFRRRFFFFFFFFFFFTGFFFFFFFFFFFFFFFFFFFFTFFFFGGGGGFFFFF
MMMMMMMMMMDDDDDDDDDFFFFFFFFFFFFFFFFFFFFFFFFFRRRFFFFFFFFGGFFFFFFFFFFFFFFFFFFFGGGGGGGGGGGGGGGGGTGFFFFRRRFFFFFFFFFFFFGFFFFFFFFFFFFFFFFFFFFFFFFFGGGGGFFFFF
MMMMMMMMMMDDDDDDDDDFFTFFFFFFFFFFFFFFFFFFFFFFRRRFFFFFFFFGGFFFFFFFFFFFFFFFFFFFGGGGGGGGGGGGGGGGGGGFFFFRRRFFFFFFFFFFFFGFFFFFFFFFFFFFFFFFFFFTFFFFGGGGGFFFFF
MMMMMMMMMMDDDDDDDDDFFFTFFFFFFFFFFFFFTFFFFFTFRRRFFFFFFFFGGFFFFFTFFFFFFFFFFFFFGGGGGGGGGGGGGGGGGGGFFFFRRRFFFFFFFFFFFFGFFFFFFFFFFFFFFFFFFFFFFFFFGGGGGFFFFF
MMMMMMMMMMDDDDDMMMMFFFFFFFFTFFFFFFFFFFFFFFFFRRRFFFGGGGGGGFFFFFFFFFFFFFDDDDDFFFFFGGGGGGGGGGGGGGGFFFFRRRFFFFFFFFFFFFGGGGGGGGGGGGGGGGFFFFFFFFFFFFFFFFFFFF
MMMMMMMMMMDDDDDMMMMFFFFFFFFFFFFFFFFFFFFFFTFFRRRFFFGGGGGGGFFFFFFFFFFFTFDDDDDFFFFFTGGGGGGGGGGGGGGFFFFRRRFFFFFFFFFFFFGGGGGGGGGGGGGGGGFFFFFFFFFFFFFFFFFFFF
MMMMMMMMMMDDDDDMMMMFFFFFFFFFFFFFFFFFFFFFFFFFRRRFFFGGTGGGGFFFFFFFFFFFFFDDDDDFFFFFGTGGGGGGGGGGGGGFFFFRRRFFFFFFFFFFFFGGGGGGGGGGGGGGGGFFFFFFFFFFFFFFFFFFFF
MMMMMMMMMMDDDDDMMMMFFFFFFFTFFFFFFFFFFFFFFFFFRRRFFFGGGGGGGFTFFFFFFFFFFFDDDDDFFFFFGGGGGGGGGGGGGGGFFFFRRRFFFFFFFFFFFFGGGGGGGGGGGGGGGGFFFFFFFFFFFFFFFFFFFF
MMMMMMMMMMDDDDDMMMMFFFFFFFFFFFFFFFFFFFFFFFFFRRRFFFGGGGGGGFFFFFFFFFTFFFDDDDDFFFFFGGGGGGGGGGGGGGGFFFFRRRFFFFFFFFFFFFGGGGGGGGGGGGGGGGFFFFFFFFFFFFFFFFFFFF
